11,2,472,158,314,1
129.99,2,138,113,25,1
47.99,2,87,34,53,0
8.01,2,587,268,319,1
8.2,2,83,54,29,1
23.49,2,89,54,35,1
5,2,275,93,182,1
13.53,2,183,126,57,1
59.8,3,79,24,55,0
51.6,3,126,28,98,0
2.36,4,23,8,15,0
23.36,2,258,149,109,1
59.9,3,63,61,2,0
47.5,2,58,3,55,0
6.99,2,254,148,106,1
24.43,3,96,96,0,0
7.05,2,78,21,57,1
6.28,2,96,69,27,1
6.99,2,286,133,153,1
5.93,4,54,18,36,1
